11111111111111111111
10C100010C010C010001
10000E0P000000010001
11000111001110000011
10110101001010000001
11111111111111111111
