








11111
10001
10001
1ECP1
10001
11111















