11111111111111111111
10C100010C010C010001
10000C00P00000010001
11000111001110000011
101101010010100E0001
1111111111111111111


